0003223000
0334334330
1111111111
2222222222
0434004340
0444004440
0000000000
0000000000