1212332121
0030000300
0111111110
1111441111
2222222222
0000000000
0000000000
0000000000